*/chest	chest,nose,hair,napkin,lipstick,shirt,pants,teeth,clothes,throat
*/tempe	tempe,chandler,henderson,mesa,scottsdale,phoenix,summerlin,gilbert,charlotte,downtown
*/short_ribs	short_ribs,short_rib,pork,pork_belly,bulgogi,beef,braised,lamb,spare_ribs,shrimp
*/amaretto	amaretto,vanilla,raspberry,strawberry,caramel,salted_caramel,chocolate,white_chocolate,passion_fruit,hazelnut
*/pepper_jelly	pepper_jelly,aioli,dill,tomato,onions,melted_cheese,sauce,caramelized_onions,toasted_bread,garlic
*/relies	relies,focus,lack,creativity,innovation,execution,improve,improving,based,focuses
*/travis	travis,manager,personable,outgoing,rude,polite,general_manager,gm,owner,professional
*/free_admission	free_admission,resort_fee,tickets,reservation,reservations,booked,ladies_night,coupons,coupon,pm
*/exposed_brick	exposed_brick,dark_wood,high_ceilings,lighting,brick_walls,decor,chandeliers,paneling,light_fixtures,murals
*/chest/cloth	cloth,hands,napkins,towel,utensils,napkin,wipe,rim,ripped,washing
*/chest/wiped	wiped,rubbing,wiping,carrying,stare,picking,scratching,pouring,sick,running
*/chest/soap	soap,shower,tub,shampoo,yuck,towels,gel,lotion,dust,conditioner
*/chest/t_shirt	t_shirt,sweater,socks,button,tie,shorts,wearing,wear,shirt,hats
*/chest/chewed	chewed,finishing,pulled,leg,biting,hung,dropped,broke,container,sucked
*/chest/broken	broken,fridge,circle,crap,cracked,cigarette_smoke,bed,holes,held,step
*/chest/trap	trap,teeth,throat,poop,cast,foot,cracks,ears,gum,ear
*/chest/numb	numb,joy,brain,burn,hurt,stomach,hurts,stomachs,pig,fire
*/chest/staring	staring,slapped,shut,shock,directly,slowly,smack,rolled,shoved,fly
*/chest/wavy	wavy,hair,grey,purple,curly,tied,beard,gray,suddenly,wore
*/tempe/intersection	intersection,street,plaza,shopping_center,park,blvd,road,rd,st,101
*/tempe/thai	thai,vietnamese,mediterranean,chinese_food,middle_eastern,chinese,caribbean,ayce_sushi,indian,japanese
*/tempe/chinatown	chinatown,richmond_hill,yonge,mississauga,scarborough,finch,north_york,aurora,real_deal,spadina
*/tempe/heritage	heritage,tavern,arts,island,sabor,nightlife,barrio,roosevelt,formerly,coronado
*/tempe/chicago	chicago,jersey,deep_dish,nyc,seattle,cali,ny,orange_county,los_angeles,texas
*/tempe/establishments	establishments,steakhouses,sushi_joints,buffets,dining_options,cities,similar_places,joints,spots,competitors
*/tempe/recently_moved	recently_moved,month_ago,moving,moved,everytime,thrilled,ecstatic,lives,excited,ventured
*/tempe/dutch_bros	dutch_bros,chick_fil_a,tj,panera,pita_jungle,dunkin,red_robin,starbucks,pizza_hut,taco_bell
*/tempe/tempe	tempe,mesa,chandler,gilbert,glendale,north_phoenix,camelback,scottsdale,north_scottsdale,downtown_phoenix
*/tempe/hotspot	hotspot,haunt,rotation,absolute_favorite,smokehouse,destination,independent,continues,family_owned,brand
*/short_ribs/pulled_pork	pulled_pork,brisket,ribs,rib_tips,hot_links,tri_tip,smoked_meat,st_louis,chopped_brisket,meat_platter
*/short_ribs/bowls	bowls,sizes,deluxe,portions,variations,raw_fish,pcs,servings,lunch_specials,choices
*/short_ribs/carnitas	carnitas,carne_asada,al_pastor,pastor,adobada,cheese_enchiladas,quesadilla,pollo,carne,taco
*/short_ribs/kebab	kebab,shawarma,kabob,falafel,gyro,koobideh,biryani,kafta,chicken_kabob,vindaloo
*/short_ribs/fried_rice	fried_rice,pad_thai,chow_mein,egg_rolls,orange_chicken,mongolian,cantonese,chow_mien,pad_see_ew,egg_roll
*/short_ribs/mussels	mussels,clams,crawfish,oysters,calamari,raw_oysters,king_crab,crab_legs,linguini,shellfish
*/short_ribs/filet_mignon	filet_mignon,ribeye,filet,medium_rare,rib_eye,med_rare,tenderloin,sirloin,dry_aged,sirloin_steak
*/short_ribs/rabbit	rabbit,bolognese,raviolis,pappardelle,spaghetti,venison,osso_buco,elk,gnocchi,ravioli
*/short_ribs/sashimi	sashimi,nigiri,yellowtail,tataki,tuna,maki,yellow_tail,spicy_salmon,spicy_tuna,uni
*/short_ribs/bulgogi	bulgogi,bibimbap,kalbi,kimchi,korean,galbi,japchae,pork_bone_soup,spicy_pork,banchan
*/amaretto/souffl	souffl,tiramisu,creme_brulee,lava,souffle,flan,br,deserts,tres_leches,cannoli
*/amaretto/vodka	vodka,gin,beers,mixed_drinks,martini,alcohol,tequila,sake,bloody_mary,pours
*/amaretto/raspberry	raspberry,berry,cherry,white_chocolate,blueberry,orange,rose,cranberry,poppy,strawberry
*/amaretto/watermelon	watermelon,moscow,sangria,mule,prickly_pear,hibiscus,cider,blood_orange,lemonade,mojito
*/amaretto/ice_cream	ice_cream,scoop,hot_fudge,soft_serve,scoops,chocolate_syrup,icecream,brownie,waffle_cone,cookie_dough
*/amaretto/frosted	frosted,frosting,cupcake,doughnut,icing,donut,cupcakes,donuts,red_velvet,doughnuts
*/amaretto/taro	taro,tapioca,sago,bubble_tea,boba,snow,grass_jelly,milk,tea,bubbles
*/amaretto/candies	candies,snacks,candy,varieties,chocolates,ms,treats,pies,mixes,imported
*/amaretto/bourbon	bourbon,scotch,sticky_toffee_pudding,maple,pumpkin_pie,apple_crisp,apple_pie,pumpkin,cinnamon,foster
*/amaretto/mocha	mocha,iced_coffee,americano,cold_brew,drip_coffee,cappuccino,almond_milk,decaf,chai_latte,hot_chocolate
*/pepper_jelly/pretzels	pretzels,pretzel,fondue,pretzel_sticks,fried_pickles,sweet_potato_tots,fried_mushrooms,complimentary_bread,soft_pretzel,garlic_knots
*/pepper_jelly/dry	dry,tough,overcooked,rubbery,flavorless,bland,mushy,undercooked,boring,tasteless
*/pepper_jelly/arugula	arugula,goat_cheese,pear,pears,walnuts,gorgonzola,vinaigrette,arugula_salad,burrata,fennel
*/pepper_jelly/cilantro	cilantro,lime,hot_salsa,green,pickled_carrots,lime_juice,limes,pico,salsa,hot_sauces
*/pepper_jelly/roasted_red_peppers	roasted_red_peppers,fresh_mozzarella,mozzarella,olives,artichokes,feta,pesto,fresh_basil,artichoke,salami
*/pepper_jelly/onion_straws	onion_straws,cheeseburger,pretzel_bun,grilled_onions,turkey_burger,chipotle,brioche_bun,bleu,double_cheeseburger,hotdog
*/pepper_jelly/delicate	delicate,smooth,silky,rich,buttery,flavourful,wonderfully,flaky,tartness,savory
*/pepper_jelly/pieces	pieces,slices,small_pieces,strips,inch,cubes,slivers,halves,tiny_pieces,tablespoons
*/pepper_jelly/green_beans	green_beans,mashed_potatoes,okra,fried_okra,collard_greens,collards,brussel_sprouts,yams,steamed_veggies,broccoli
*/pepper_jelly/eggs	eggs,hash_browns,hashbrowns,scrambled_eggs,corned_beef_hash,home_fries,toast,omelets,breakfast_burrito,seasoned_potatoes
*/relies/remain	remain,carry,reference,trend,basics,becoming,likely,particular,popular,describe
*/relies/pride	pride,culture,ability,recipes,win,support,risk,successful,necessary,survive
*/relies/focused	focused,focus,focusing,overwhelming,emphasis,common,excel,regards,competing,enhance
*/relies/expensive	expensive,pricey,quantity,extensive,compared,overpriced,inflated,average,wow_factor,justify
*/relies/american	american,palate,staples,worthy,appeal,winner,favor,claim,challenge,heavily
*/relies/potential	potential,sucks,improvement,quality_control,improvements,appears,shame,changes,ownership,food_quality
*/relies/leadership	leadership,organization,concern,staffing,effort,apparent,common_sense,skills,aware,aspects
*/relies/improve	improve,hopefully,encourage,match,provide,improving,maintain,improved,afraid,handle
*/relies/execution	execution,quality_ingredients,technique,intense,exceptional,diversity,creative,concept,par,depth
*/relies/solely	solely,strictly,alone,star,fair,rating,purely,based,stars,disclaimer
*/travis/pay_attention	pay_attention,train,jobs,lazy,trained,hire,act,manners,lesson,training
*/travis/alex	alex,mike,john,amanda,ashley,james,paul,emily,brian,steven
*/travis/male	male,loudly,younger,blonde,cash_register,female,woman,standing,gentlemen,grumpy
*/travis/apologized	apologized,apologized_profusely,comped,apologize,delay,screwed,notified,inconvenience,replacement,remake
*/travis/called	called,call,spoke,stated,phone_number,complain,contacted,calling,liar,sent
*/travis/friendly	friendly,efficient,personable,talkative,knowledgeable,prompt,extremely_friendly,courteous,knowledgable,attentive
*/travis/rude	rude,disrespectful,unfriendly,unhelpful,extremely_rude,shocked,rudeness,claimed,upset,angry
*/travis/greeted	greeted,immediately_greeted,greeted_immediately,warmly,introduced,welcomed,entered,warmly_greeted,seated,greet
*/travis/taylor	taylor,kudos,anthony,matt,jay,tony,greg,jason,derek,rachel
*/travis/argued	argued,lied,nerve,argue,questioned,laughed,payment,owed,refused,lie
*/free_admission/livingsocial	livingsocial,mobile,order_online,yelp,amazon,takeout,groupon,print,online,dozen
*/free_admission/hotel	hotel,trump,mandalay_bay,mgm,hotel_room,stay,mgm_grand,luxor,staying,valet
*/free_admission/june	june,july,2015,january,celebrated,wedding_anniversary,december,august,march,birthday_dinner
*/free_admission/marquee	marquee,hakkasan,lavo,shopping,tao,palms,xs,pool_party,bowling,guest_list
*/free_admission/approximately	approximately,45,00pm,min,pm,30,30pm,noon,arrived,minutes
*/free_admission/tax	tax,gratuity,taxes,70,80,32,18,27,tip,19
*/free_admission/dinner	dinner,date_night,girlfriends,planned,bachelorette_party,dined,heading,lunch,vacation,weeks_ago
*/free_admission/thursdays	thursdays,tuesdays,saturdays,mondays,fridays,drink_specials,wednesdays,evenings,fyi,happy_hour
*/free_admission/points	points,card,earn_points,rewards,gamble,club_card,account,reward,rewards_card,kiosk
*/free_admission/coupons	coupons,coupon,discounts,regularly,rewards_program,deals,mail,cards,weekly,stamps
*/exposed_brick/draped	draped,chandeliers,concrete,marble,chandelier,reds,woods,touches,christmas_lights,crystal
*/exposed_brick/newer	newer,cleaner,remodeled,property,renovated,brighter,updated,dated,nicer,older
*/exposed_brick/music_videos	music_videos,playing,movies,games,dj,jukebox,played,tunes,play,spinning
*/exposed_brick/elements	elements,esque,theme,themed,antique,charm,decorated,lines,fashion,cafes
*/exposed_brick/modern	modern,trendy,chic,sophisticated,classy,vibe,sleek,elegant,atmosphere,contemporary
*/exposed_brick/seating	seating,couples,groups,ample_seating,private_room,wifi,outlets,larger_parties,dining_space,dance_floor
*/exposed_brick/posters	posters,pictures,photos,memorabilia,celebrities,art,celebrity,trinkets,album,covers
*/exposed_brick/bathroom	bathroom,bedroom,women,men,bathrooms,elevator,closet,hallways,hallway,room
*/exposed_brick/tables	tables,stools,booths,chairs,picnic,bar_stools,benches,seats,sushi_bar,communal
*/exposed_brick/windows	windows,weather,bellagio_fountains,river,lake,overlooking,deck,balcony,breeze,facing
