*/main_dish	main_dish,entree,appetizer,main_entree,fried_rice,drunken_noodles,shrimp,pad_thai,panang_curry,sea_bass
*/south_hills	south_hills,phoenix,charlotte,tempe,mesa,madison,summerlin,sun_prairie,neighborhood,glendale
*/high_ceilings	high_ceilings,exposed_brick,dark_wood,high_ceiling,cozy,tall_ceilings,low_lighting,dark_woods,dim_lighting,chandeliers
*/u00e9tait_pas	u00e9tait_pas,qui,mieux,lu00e0,bien,dans,avoir,peut_u00eatre,des,mais_pas
*/main_dish/dinners	dinners,pizzas,lunches,pasta_dishes,plates,drink_orders,servings,kids_meals,orders,family_style
*/main_dish/carne_asada	carne_asada,carnitas,taco,burrito,enchiladas,burritos,enchilada,tacos,chimichanga,baja
*/main_dish/panang	panang,pad_thai,panang_curry,papaya,thai,yellow_curry,pad_see_ew,drunken_noodles,penang,lemongrass
*/main_dish/korma	korma,chicken_tikka_masala,biryani,paneer,saag,palak_paneer,samosas,pakora,dosa,masala
*/main_dish/halibut	halibut,filet,diver,swordfish,filet_mignon,pan_roasted,pork_tenderloin,king_crab,rib_eye,beef_wellington
*/main_dish/babaganoush	babaganoush,falafel,gyros,shawarma,gyro,kafta,greek,kebab,baba_ganoush,dolmas
*/main_dish/sashimi	sashimi,nigiri,spicy_tuna,california_roll,maki,spicy_tuna_roll,yellowtail,yellow_tail,rainbow_roll,albacore
*/main_dish/lasagna	lasagna,chicken_parm,alfredo,eggplant_parm,spaghetti,fettuccine_alfredo,marsala,chicken_parmigiana,baked_ziti,chicken_parmesan
*/main_dish/chow_mein	chow_mein,wonton,orange_chicken,mongolian,chow_fun,general_tso,lo_mein,congee,szechuan,chinese
*/main_dish/buffalo_chicken_wrap	buffalo_chicken_wrap,chicken_fingers,buffalo,tenders,cheesesteak,club_sandwich,fried_pickles,chicken_wrap,blt,philly
*/south_hills/hayden	hayden,19th_ave,alma_school,101,shea,7th_ave,7th_st,greenway,durango,thunderbird
*/south_hills/ny	ny,york,brooklyn,san_fran,nj,jersey,nyc,boston,vancouver,miami
*/south_hills/visiting_family	visiting_family,running_errands,vacationing,relatives,colleagues,thanksgiving,visiting,recent_visit,honeymoon,sedona
*/south_hills/wine_bar	wine_bar,pizza_joint,local_spot,hideaway,hula,italian_joint,gem,dive_bar,coffeeshop,barber_shop
*/south_hills/mont_royal	mont_royal,port,downtown_montreal,touristy,metro_station,plateau,notre_dame,royal_mile,cobblestone,train_station
*/south_hills/high_expectations	high_expectations,low_expectations,high_hopes,skeptical,pleasantly_surprised,extremely_disappointed,biased,hesitant,expectations,expectation
*/south_hills/mesa	mesa,queen_creek,casa_grande,glendale,tempe,fountain_hills,summerlin,north_scottsdale,ahwatukee,tucson
*/south_hills/wynn	wynn,mirage,monte_carlo,aria,planet_hollywood,excalibur,venetian,cosmopolitan,mandarin,mandalay_bay
*/south_hills/italian_places	italian_places,steakhouses,thai_places,sushi_spots,chinese_places,indian_buffets,nail_salons,steak_houses,chinese_buffets,pho_places
*/south_hills/renowned	renowned,caffe,legendary,oldest,celebrated,hot_spot,hidden_gems,brasserie,famous,independent
*/high_ceilings/intimate	intimate,romantic,casual,relaxed,cozy,quaint,secluded,homey,atmosphere,private
*/high_ceilings/structure	structure,exhibits,chapel,court,built,stadium,gift_shop,abandoned,building,buildings
*/high_ceilings/sidewalk	sidewalk,action,bellagio_fountains,tunnel,river,alley,lake,terrace,overlooking,garden
*/high_ceilings/tile	tile,cabinets,tiles,ceiling,mosaic,plaster,wall_paper,counters,concrete,ceiling_tiles
*/high_ceilings/paintings	paintings,prints,knick_knacks,decorations,drawings,artifacts,wall,artwork,framed,bright_colors
*/high_ceilings/wood	wood,brick,benches,dark_wood,open_kitchen,bar_stools,booths,fireplaces,vinyl,chairs
*/high_ceilings/comfortable_bed	comfortable_bed,suites,kitchenette,comfy_bed,flat_screen_tv,suite,high_tech,comfortable_beds,absolutely_gorgeous,recently_remodeled
*/high_ceilings/lounging	lounging,large_groups,gaming,poolside,workout,free_weights,pool_tables,sitting_area,dance_floor,couch
*/high_ceilings/contemporary	contemporary,sophisticated,trendy,chic,stylish,modern,fits,sleek,artistic,hip
*/high_ceilings/warm_tones	warm_tones,browns,reds,gloomy,darker,bamboo,linen,soothing,scheme,airy
*/main_dish/dinners/servings	servings,bowls,huge_portion,portion_sizes,appetites,portion_size,plates,serving_size,portioned,price_tag
*/main_dish/dinners/19	19,13,18,22,17,36,26,99,23,38
*/main_dish/dinners/salads	salads,sandwiches,soups,pastas,pasta_dishes,paninis,pizzas,variations,fare,marginal
*/main_dish/dinners/vegetarian_options	vegetarian_options,offerings,limited_menu,healthy_options,vegetarians,vegetarian_dishes,vegans,meatless,seafood_dishes,comfort_food
*/main_dish/dinners/prix_fixe_menu	prix_fixe_menu,tasting_menu,restaurant_week,tapas,prix_fixe,pre_fix,wine_pairing,small_plates,ala_carte,regular_menu
*/main_dish/dinners/super_hungry	super_hungry,big_eater,eater,food_poisoning,big_portion,crabcakes,eaten,adventurous,memorable,carnivore
*/main_dish/dinners/entree	entree,entru00e9e,main_dish,main_entree,app,starter,main_dishes,main_courses,starters,appetizer
*/main_dish/dinners/lunch_specials	lunch_specials,lunch_special,daily_specials,combos,lunches,lunch_buffet,dinners,dinner_specials,lunch_combos,kids_meals
*/main_dish/carne_asada/chimichanga	chimichanga,burrito,carne_asada,quesadilla,burritos,carnitas,tostada,cheese_crisp,barbacoa,fajita
*/main_dish/carne_asada/enchiladas	enchiladas,chicken_enchiladas,fajitas,enchilada,cheese_enchiladas,tamales,chile_relleno,chimi,relleno,mole
*/main_dish/carne_asada/pollo	pollo,carne,papas,pescado,arroz,ropa_vieja,camarones,lomo,asado,stuffed_peppers
*/main_dish/carne_asada/catfish	catfish,fried_fish,red_beans_and_rice,grilled_fish,grilled_shrimp,pork_shoulder,creole,achiote,dining_companions,lettuce_wrap
*/main_dish/carne_asada/posole	posole,tortilla_soup,menudo,pozole,huevos_rancheros,chowder,yucatan,peruvian,pablo_picasso,jerk
*/main_dish/panang/tom_kha	tom_kha,tom_yum,lemongrass,recommendation,koong,tom_kah_kai,tom_ka,curry,thai_curry,hot_pot
*/main_dish/panang/satay	satay,chicken_lettuce_wraps,fried_tofu,summer_rolls,spicy_thai,veggie_spring_rolls,papaya,roti,sate,cashew
*/main_dish/panang/drunken_noodles	drunken_noodles,pad_thai,panang_curry,pad_see_ew,drunken_noodle,panang,spicy_basil,yellow_curry,tom_yum_soup,penang
*/main_dish/korma/vindaloo	vindaloo,tikka_masala,biryani,lamb_curry,masala,tikka,samosas,samosa,indian_cuisine,curried_chicken
*/main_dish/korma/chicken_tikka_masala	chicken_tikka_masala,lamb_vindaloo,tandoori_chicken,korma,paneer,saag,palak_paneer,goat,chicken_masala,chicken_tandoori
*/main_dish/halibut/rib_eye	rib_eye,ribeye,dry_aged,rib_eye_steak,medium_rare,bone,filet_mignon,filet,med_rare,fillet_mignon
*/main_dish/halibut/carpaccio	carpaccio,tartare,cheese_plate,confit,bacon_wrapped_dates,braised,grilled_octopus,tuna_tartar,butternut_squash_soup,duo
*/main_dish/halibut/pork_loin	pork_loin,pork_tenderloin,flank_steak,sirloin,tenderloin,veal,lamb_chops,roasted_chicken,pork_chop,lamb_chop
*/main_dish/halibut/calamari	calamari,oyster,jumbo,steamed_mussels,tilapia,fresh_oysters,haddock,mackerel,escargots,heart_attack
*/main_dish/halibut/wagyu_beef	wagyu_beef,kobe_beef,wagyu,kobe,waygu,foie_gras,bison,pork_belly,seared_foie_gras,fois_gras
*/main_dish/halibut/seared_scallops	seared_scallops,wild_mushroom,bacon_wrapped_shrimp,au_gratin,trio,beer_battered,potato_gratin,lobster_bisque,pan_roasted,grilled_halibut
*/main_dish/halibut/king_crab_legs	king_crab_legs,crab_legs,crawfish,snow_crab_legs,oysters,prime_rib,lobster_tails,raw_oysters,king_crab,crab_claws
*/main_dish/halibut/risotto	risotto,gnocchi,pappardelle,raviolis,cioppino,pea_soup,rabbit,sweetbreads,succotash,sweet_pea
*/main_dish/halibut/scallops	scallops,scallop,sea_scallops,prawns,lobster_tail,diver,fried_oysters,crab_leg,jumbo_shrimp,prawn
*/main_dish/halibut/halibut	halibut,sea_bass,swordfish,trout,red_snapper,salmon,snapper,mahi_mahi,grouper,chilean_sea_bass
*/main_dish/babaganoush/baba_ganoush	baba_ganoush,falafel,baba_ghanoush,stuffed_grape_leaves,babaganoush,spinach_pie,tabouleh,dolmas,moussaka,saganaki
*/main_dish/sashimi/spicy_tuna_roll	spicy_tuna_roll,rainbow_roll,california_roll,spicy_tuna,tuna_roll,spicy_salmon,sushi_roll,dragon,spider_roll,maki
*/main_dish/sashimi/sashimi	sashimi,nigiri,nigiri_sushi,raw_fish,yellowtail,albacore,hamachi,yellow_tail,fresh_fish,ahi_poke
*/main_dish/sashimi/bento	bento,bento_box,hibachi,teriyaki,spam_musubi,teppanyaki,bento_boxes,miso_soup,japanese,hibachi_chicken
*/main_dish/sashimi/octopus	octopus,squid,shrimps,baby_octopus,beef_tongue,sea_urchin,grilled_squid,skewer,jellyfish,crabs
*/main_dish/sashimi/karaage	karaage,edamame,yakitori,agedashi_tofu,takoyaki,hamachi_kama,tako,shishito_peppers,standouts,robata
*/main_dish/lasagna/fettucine	fettucine,pasta_dish,penne,linguine,linguini,alfredo,fettuccine_alfredo,shrimp_scampi,scampi,marsala
*/main_dish/lasagna/brother	brother,fiance,fiancu00e9,coworker,partner,colleague,companion,dining_companion,dining_partner,husbands
*/main_dish/lasagna/cavatelli	cavatelli,ravioli,gnocci,bolognese,carbonara,tagliatelle,tortellini,cannelloni,fettucini,orecchiette
*/main_dish/lasagna/chicken_parm	chicken_parm,meatball,chicken_parmesan,eggplant_parm,chicken_parmigiana,eggplant_parmesan,hero,veal_parm,baked_ziti,meatballs
*/main_dish/lasagna/caprese_salad	caprese_salad,bruschetta,caprese,caesar_salad,margherita_pizza,margarita_pizza,cesar_salad,antipasto,stuffed_mushrooms,ceaser_salad
*/main_dish/chow_mein/rare_beef	rare_beef,bun_bo_hue,grilled_pork,vermicelli,banh_mi,tendon,pho_tai,bbq_pork,oxtail,tripe
*/main_dish/chow_mein/lo_mein	lo_mein,orange_chicken,chow_mein,kung_pao_chicken,general_tso,kung_pao,chow_mien,egg_foo_young,beef_chow_fun,mongolian
*/main_dish/chow_mein/dumpling	dumpling,dumplings,bao,xiao_long_bao,dim_sum,shumai,pork_buns,steamed_buns,steamed_dumplings,pot_sticker
*/main_dish/chow_mein/egg_roll	egg_roll,spring_roll,eggroll,crab_puff,crab_puffs,fried_wontons,wonton,spring_rolls,steamed_rice,pot_stickers
*/main_dish/chow_mein/bulgogi	bulgogi,kimchi,galbi,spicy_pork,bibimbap,combo_plate,korean,bbq_beef,mandu,bbq_ribs
*/main_dish/chow_mein/tofu	tofu,stir_fried,spicy_chicken,fish_balls,mixed_veggies,stir_fry,soondubu,rice_cake,vegi,shiitake
*/main_dish/chow_mein/cantonese	cantonese,taiwanese,szechuan,sichuan,chinese,szechwan,hotpot,chinese_food,chinese_dishes,hong_kong_style
*/main_dish/chow_mein/udon	udon,yakisoba,ramen,soba,shabu_shabu,sukiyaki,tonkatsu,noodle,noodle_dish,saimin
*/main_dish/chow_mein/oyster_sauce	oyster_sauce,house_special,minced_pork,clay_pot,crispy_noodles,mixed_vegetables,snow_peas,fried_noodles,baby_bok_choy,roasted_duck
*/main_dish/buffalo_chicken_wrap/cajun	cajun,rotisserie,fella,chix,combo,personal_favorites,appetizer_sampler,favorites_include,crab_dip,grilled_veggie
*/main_dish/buffalo_chicken_wrap/fried_zucchini	fried_zucchini,fried_pickles,mozzarella_sticks,fried_mushrooms,potato_skins,jalapeno_poppers,spinach_dip,pretzel_bites,fried_pickle,spinach_artichoke_dip
*/main_dish/buffalo_chicken_wrap/blackened_salmon	blackened_salmon,chopped_salad,chicken_wrap,seared_ahi,blackened_chicken,firecracker,bang_bang_shrimp,cobb,smoked_chicken,chopped_chicken
*/main_dish/buffalo_chicken_wrap/portabello	portabello,veggie_wrap,deluxe,supreme,lunch_combo,togo,coworkers,ruben,sounded_delicious,takeout
*/main_dish/buffalo_chicken_wrap/fried_chicken	fried_chicken,brisket,pulled_pork,fried_catfish,pot_roast,country_fried_steak,chicken_fried_steak,hot_dogs,benedict,roast_chicken
*/main_dish/buffalo_chicken_wrap/chicken_tenders	chicken_tenders,chicken_fingers,boneless_wings,tenders,buffalo,chicken_finger,hamburgers,bbq_chicken,wing,sliders
*/main_dish/buffalo_chicken_wrap/reuben_sandwich	reuben_sandwich,club_sandwich,french_dip,blt,meatloaf,cheesesteak,cuban_sandwich,breakfast_burrito,monte_cristo,chicken_pot_pie
*/south_hills/hayden/pkwy	pkwy,parkway,lunchtime,boca,downhill,creek,recently_opened,closer,vicinity,gordon_biersch
*/south_hills/hayden/durango	durango,decatur,rainbow,215,warm_springs,charleston,jones,lake_mead,sahara,freeway
*/south_hills/hayden/outback	outback,mcdonalds,mcdonald,pei_wei,jimmy_john,carolina,alexander,paradise,cracked_egg,sushi_brokers
*/south_hills/hayden/plaza	plaza,buffalo_wild_wings,grocery,target,strip_mall,harris_teeter,smith,shopping_plaza,jimmy_johns,costco
*/south_hills/hayden/shea	shea,101,thunderbird,peoria,indian_bend,deer_valley,greenway,hayden,bell_road,alma_school
*/south_hills/hayden/scottsdale_quarter	scottsdale_quarter,tempe_marketplace,kierland_commons,kona_grill,arrowhead,shopping_center,farmers_market,newly_opened,roosevelt,south_mountain
*/south_hills/hayden/chandler_location	chandler_location,jade,palace,bobby,future,highlands,ivy,scottsdale_fashion_square,lee_lee,busier
*/south_hills/hayden/starbucks	starbucks,taco_bell,food_court,kfc,walmart,wal_mart,krispy_kreme,franchise,carl,fashion_square
*/south_hills/hayden/south	south,north,border,spectrum,road,main_street,southeast,main_drag,pineville,independence
*/south_hills/ny/transplanted	transplanted,born,californian,planet,transplant,transplants,native,entire_life,england,replicate
*/south_hills/ny/rival	rival,compare,compares,closest,caliber,lee,lotus,saigon,country,comparable
*/south_hills/ny/seattle	seattle,bay_area,portland,san_jose,orange_county,southern_california,west_coast,california,hawaii,denver
*/south_hills/ny/thailand	thailand,japan,korea,asia,spain,europe,mexico,taiwan,france,italy
*/south_hills/ny/san_diego	san_diego,oregon,beverly_hills,washington,numerous_times,northern,albuquerque,canada,pa,suburb
*/south_hills/ny/katz	katz,jewish_deli,carnegie,jersey,brooklyn,jewish,ruth,york,ny,central_park
*/south_hills/ny/memphis	memphis,texas,kansas_city,famous_dave,north_carolina,roadhouse,kansas,brazil,southern,mississippi
*/south_hills/ny/wisconsin	wisconsin,utah,minnesota,michigan,suburbs,illinois,germany,childhood,grew,addicted
*/south_hills/ny/neapolitan	neapolitan,napoli,pizza_hut,chicago_style_pizza,rome,ny_style_pizza,lou_malnati,pizza_snob,carmine,windy_city
*/south_hills/ny/san_francisco	san_francisco,los_angeles,boston,nyc,miami,nj,vancouver,toronto,atlanta,london
*/south_hills/visiting_family/venture	venture,trek,ventured,heading,adventure,frequent,travel,exploring,driving,headed
*/south_hills/visiting_family/lived	lived,traveled,recently_moved,frequented,driven,decade,moved,visited,relocating,travelled
*/south_hills/visiting_family/2006	2006,2010,2007,2008,2009,2004,2005,2003,ago,months_ago
*/south_hills/visiting_family/trip	trip,trips,honeymoon,layover,getaway,spring_training,sightseeing,business_trips,excursion,sedona
*/south_hills/visiting_family/relatives	relatives,colleagues,uncle,frequently,lives,resident,visiting_family,vacationing,fond_memories,travelling
*/south_hills/visiting_family/bike_ride	bike_ride,running_errands,detour,grand_canyon,stumbled,pit_stop,jaunt,stumble,visiting_phoenix,stopping
*/south_hills/visiting_family/christmas_eve	christmas_eve,thanksgiving,sunday_night,valentine,easter,eve,sunday_brunch,weekend,recent_visit,weeks_ago
*/south_hills/wine_bar/sushi_joint	sushi_joint,joint,burger_joint,pizza_joint,mexican_joint,eatery,dive_bar,watering_hole,local_spot,neighborhood_bar
*/south_hills/wine_bar/italian_deli	italian_deli,deli,bakery,market,chain_restaurant,cuban_food,barber_shop,grocer,villa,marketplace
*/south_hills/mont_royal/walking_distance	walking_distance,open_late,walkable,chase_field,blocks,stadiums,nearby,pnc_park,radius,stops
*/south_hills/mont_royal/uptown	uptown,uptown_charlotte,market_square,southside,town,central_ave,capitol,central,campus,saint
*/south_hills/mont_royal/intersection	intersection,street,hill,streets,across,highway,north_end,residential_area,northeast,lightrail
*/south_hills/mont_royal/uw	uw,proximity,cmu,residence,close_proximity,hub,union,route,east_end,bookstore
*/south_hills/mont_royal/metro_station	metro_station,light_rail,convention_center,commute,notre_dame,state_street,ballpark,nightlife,latin_quarter,windsor
*/south_hills/high_expectations/primanti_brothers	primanti_brothers,reviewer,ian,soul_food,nordstrom_rack,longest,serendipity,brazilian,fogo_de_chao,newcomer
*/south_hills/high_expectations/high_expectations	high_expectations,high_hopes,low_expectations,expectations,hype,yelp_reviews,expectation,highly_rated,hyped,bobby_flay
*/south_hills/high_expectations/officially	officially,elephant,rotation,voted,magazine,award,queen_city,lo_lo,stoked,burgh
*/south_hills/high_expectations/skeptical	skeptical,hesitant,biased,pleasantly_surprised,intrigued,super_excited,extremely_disappointed,remembered,delighted,psyched
*/south_hills/mesa/squirrel_hill	squirrel_hill,neighborhood,bloomfield,lawrenceville,downtown_phoenix,plaza_midwood,central_phoenix,east_liberty,stockbridge,fitchburg
*/south_hills/mesa/madison	madison,pittsburgh,charlotte,champaign,oakland,phoenix,qc,university,arizona,sun_prairie
*/south_hills/mesa/summerlin	summerlin,north_las_vegas,valley,northwest,nw,spring_valley,downtown,farther,north_west,business_district
*/south_hills/mesa/mesa	mesa,tempe,glendale,queen_creek,ahwatukee,north_phoenix,fountain_hills,north_scottsdale,tucson,scottsdale
*/south_hills/wynn/mirage	mirage,mandalay_bay,luxor,monte_carlo,aria,wynn,cosmopolitan,venetian,planet_hollywood,mgm
*/south_hills/wynn/marriott	marriott,hilton,hyatt,holiday_inn,embassy_suites,hampton_inn,ritz_carlton,fairmont,properties,hotels
*/south_hills/wynn/del_frisco	del_frisco,flemings,wolfgang_puck,ocean,melting_pot,steakhouse,tornado,grille,charlie,roku
*/south_hills/wynn/saguaro	saguaro,canyon,ruby,phoenician,staycation,fiesta,nordstrom,squaw_peak,loews,performing_arts
*/south_hills/italian_places/venues	venues,establishments,resorts,spots,pubs,locations,gyms,coffee_shops,cities,eateries
*/south_hills/italian_places/pizza_joints	pizza_joints,burger_joints,joints,chains,chain_restaurants,pizzerias,sandwich_shops,breakfast_joints,franchises,brunch_spots
*/south_hills/italian_places/cheaper	cheaper,pricier,cheapest,higher_end,price_point,superior,similar,bargain,fancier,elsewhere
*/south_hills/italian_places/stores	stores,shops,grocery_stores,salons,supermarkets,gems,grocers,coffee_houses,shopping_centers,bakeries
*/south_hills/italian_places/thai_places	thai_places,pho_places,chinese_places,steakhouses,chinese_buffets,bbq_places,sushi_joints,buffets,italian_places,nail_salons
*/south_hills/renowned/fox	fox,culinary_dropout,chain,church,owns,cinema,america,compete,arguably,capital
*/south_hills/renowned/community	community,locals,cultural,becoming,decades,secret,burgeoning,become,memory,glory
*/south_hills/renowned/hot_spot	hot_spot,hotspot,foodie,foodies,landmark,gastropub,exists,reputation,rarity,renowned
*/south_hills/renowned/inspired	inspired,staple,trend,roots,finest,centric,locally_owned,continental,mainstay,caffe
*/south_hills/renowned/representation	representation,dive,category,serves,scotland,institution,mecca,north_america,tradition,greasy_spoon
*/south_hills/renowned/famous	famous,infamous,legendary,iconic,beloved,oldest,fame,largest,ben,mario
*/south_hills/renowned/ultimate	ultimate,destination,elite,continues,amsterdam,award_winning,haven,namesake,prime,world_class
*/high_ceilings/structure/exhibit	exhibit,museum,exhibits,displays,gift_shop,exhibition,chapel,historical,tanks,exciting
*/high_ceilings/structure/houses	houses,homes,parks,attractions,vacant,showroom,gallery,situated,sprawling,centre
*/high_ceilings/sidewalk/corner	corner,block,opposite,action,statue,connected,garden,peek,courtyard,bellagio
*/high_ceilings/sidewalk/separated	separated,sectioned,narrow,enclosed,dinning_room,surrounding,circular,leading,dining_room,cavernous
*/high_ceilings/sidewalk/entrance	entrance,exit,walkway,escalators,sidewalk,lobby_area,corridor,entryway,path,alley
*/high_ceilings/sidewalk/deck	deck,roof,porch,balcony,terrace,river,sunny,outdoor_dining,fence,cigar
*/high_ceilings/tile/tile	tile,flooring,tiles,fixtures,cabinets,furniture,insulation,tiled,apartments,stucco
*/high_ceilings/tile/mirrors	mirrors,floor,tile_floors,shiny,corners,walls,doors,ceiling,blinds,entry
*/high_ceilings/paintings/carved_wood	carved_wood,touches,stained_glass,intriguing,modern_art,ancient,adorning,colored_walls,background_music,colourful
*/high_ceilings/paintings/paintings	paintings,sculptures,artwork,statues,murals,images,artifacts,photographs,drawings,mural
*/high_ceilings/paintings/colors	colors,patterns,decoration,designs,decorations,shapes,colorful,bright_colors,colours,decors
*/high_ceilings/paintings/adorned	adorned,decorated,covers,themed,lined,featuring,board_games,decorating,tablecloths,scattered
*/high_ceilings/wood/brick_walls	brick_walls,exposed_brick,high_ceilings,loft,exposed_brick_walls,hardwood,wooden_beams,reclaimed_wood,stone_walls,open_kitchen
*/high_ceilings/wood/comfortable_chairs	comfortable_chairs,square,nice_touch,balconies,plush,rectangular,trees,chrome,wood_paneling,candlelit
*/high_ceilings/wood/lanterns	lanterns,wooden,table_cloths,stone,wine_bottles,brick,pillars,wood,plants,vines
*/high_ceilings/wood/archways	archways,crystal,beautifully,chandelier,ornate,brass,chandeliers,flower,rounded,vaulted_ceilings
*/high_ceilings/wood/sofas	sofas,couches,sofa,chairs,comfy_chairs,benches,armchairs,leather_chairs,fireplace,leather_couches
*/high_ceilings/comfortable_bed/appointed	appointed,maintained,furnished,equipped,organized,designed,relatively,tastefully_decorated,ample_parking,high_tech
*/high_ceilings/lounging/screens	screens,flat_screens,screen,slot_machines,stadium_seating,viewing,outlets,machines,comfortable_seating,lanes
*/high_ceilings/lounging/lounge_area	lounge_area,lounge,sitting_area,waiting_area,couch,poolside,lounge_chairs,living_room,lounging,cabanas
*/high_ceilings/lounging/outdoors	outdoors,weather,outdoor_seating,picnic,warmer,indoor_seating,outdoor,fresh_air,cooler,degrees
*/high_ceilings/lounging/outdoor_patio	outdoor_patio,patio_area,outdoor_area,outdoor_seating_area,patio,indoor,open_space,pool_area,backyard,air_conditioned
*/high_ceilings/contemporary/modern	modern,contemporary,sleek,stylish,chic,rustic,industrial,modern_design,library,modern_furniture
*/high_ceilings/contemporary/vibe	vibe,low_key,divey,charm,theme,feels,sports_bar,character,concept,speakeasy
*/high_ceilings/contemporary/sophisticated	sophisticated,eclectic,trendy,hip,appealing,classy,artistic,vibrant,artsy,fits
*/high_ceilings/contemporary/minimalist	minimalist,appearance,interior_decor,gothic,exterior,victorian,futuristic,neat,image,opulent
*/high_ceilings/warm_tones/dimly_lit	dimly_lit,low_lighting,cave,dim_lighting,attractive,low_light,low_ceilings,dark_walls,illuminated,leather_booths
